7 7
*******
*i    *
* *****
*   * *
* * * *
* *  f*
*******
